Date,Test_Executed,Test_Passed,Test_Failed,Pass_Rate(%),Open_Bugs,Critical_Bugs,Code_Coverage
2024-01-01,135,116,19,85.93,24,4,35.0
2024-01-04,136,122,14,89.71,16,4,35.2
2024-01-07,140,134,6,95.71,20,8,35.3
2024-01-08,123,97,26,78.86,25,8,35.5
2024-01-10,140,133,7,95.0,13,1,35.7
2024-01-11,101,85,16,84.16,27,6,35.8
2024-01-12,136,109,27,80.15,29,1,36.0
2024-01-13,152,147,5,96.71,6,9,36.2
2024-01-14,129,120,9,93.02,17,6,36.3
2024-01-16,147,128,19,87.07,5,3,36.5
2024-01-19,75,55,20,73.33,17,2,36.7
2024-01-22,78,58,20,74.36,26,8,36.8
2024-01-24,151,130,21,86.09,23,4,37.0
2024-01-25,126,120,6,95.24,6,2,37.2
2024-01-27,155,131,24,84.52,27,4,37.3
2024-01-28,116,105,11,90.52,13,6,37.5
2024-01-31,143,123,20,86.01,15,2,37.7
2024-02-03,79,54,25,68.35,15,0,37.8
2024-02-06,108,85,23,78.7,15,1,38.0
2024-02-07,144,124,20,86.11,24,7,38.2
2024-02-10,92,79,13,85.87,6,7,38.3
2024-02-13,127,116,11,91.34,15,1,38.5
2024-02-16,143,118,25,82.52,17,4,38.7
2024-02-17,155,136,19,87.74,22,6,38.8
2024-02-20,151,130,21,86.09,25,3,39.0
2024-02-22,79,60,19,75.95,21,8,39.2
2024-02-23,81,56,25,69.14,11,4,39.3
2024-02-24,165,158,7,95.76,13,3,39.5
2024-02-25,157,134,23,85.35,13,0,39.7
2024-02-28,164,143,21,87.2,9,9,39.8
2024-03-01,91,81,10,89.01,25,4,40.0
2024-03-04,83,70,13,84.34,28,0,40.2
2024-03-07,90,79,11,87.78,20,4,40.3
2024-03-08,92,74,18,80.43,17,4,40.5
2024-03-10,169,153,16,90.53,25,5,40.7
2024-03-11,126,97,29,76.98,10,5,40.8
2024-03-14,104,95,9,91.35,7,9,41.0
2024-03-15,93,69,24,74.19,28,3,41.2
2024-03-16,152,144,8,94.74,22,7,41.3
2024-03-17,136,131,5,96.32,20,6,41.5
2024-03-18,116,96,20,82.76,27,3,41.7
2024-03-21,73,49,24,67.12,9,1,41.8
2024-03-24,131,118,13,90.08,29,3,42.0
2024-03-25,118,110,8,93.22,21,0,42.2
2024-03-28,79,53,26,67.09,7,9,42.3
2024-03-29,140,128,12,91.43,12,9,42.5
2024-04-01,151,144,7,95.36,10,4,42.7
2024-04-04,104,86,18,82.69,25,4,42.8
2024-04-05,105,77,28,73.33,21,8,43.0
2024-04-06,116,94,22,81.03,27,8,43.2
2024-04-07,168,139,29,82.74,19,5,43.3
2024-04-08,166,143,23,86.14,6,9,43.5
2024-04-09,89,84,5,94.38,7,0,43.7
2024-04-12,135,118,17,87.41,16,2,43.8
2024-04-14,133,104,29,78.2,12,7,44.0
2024-04-16,104,77,27,74.04,21,2,44.2
2024-04-17,161,147,14,91.3,5,3,44.3
2024-04-20,117,111,6,94.87,26,6,44.5
2024-04-21,91,83,8,91.21,9,7,44.7
2024-04-22,168,159,9,94.64,14,6,44.8
2024-04-23,95,69,26,72.63,26,6,45.0
2024-04-24,115,91,24,79.13,28,2,45.2
2024-04-27,109,80,29,73.39,17,9,45.3
2024-04-28,138,125,13,90.58,17,2,45.5
2024-04-30,98,83,15,84.69,29,2,45.7
2024-05-01,119,92,27,77.31,22,8,45.8
2024-05-04,163,139,24,85.28,24,4,46.0
2024-05-06,99,89,10,89.9,10,1,46.2
2024-05-07,95,77,18,81.05,22,5,46.3
2024-05-10,109,84,25,77.06,14,4,46.5
2024-05-13,134,129,5,96.27,8,6,46.7
2024-05-15,143,138,5,96.5,22,8,46.8
2024-05-18,93,72,21,77.42,17,6,47.0
2024-05-21,143,138,5,96.5,29,8,47.2
2024-05-23,124,113,11,91.13,28,8,47.3
2024-05-25,79,72,7,91.14,15,2,47.5
2024-05-26,94,65,29,69.15,24,5,47.7
2024-05-28,93,71,22,76.34,13,2,47.8
2024-05-31,130,102,28,78.46,22,6,48.0
2024-06-03,98,70,28,71.43,28,7,48.2
2024-06-05,110,95,15,86.36,5,5,48.3
2024-06-07,90,66,24,73.33,23,1,48.5
2024-06-09,141,135,6,95.74,27,8,48.7
2024-06-12,131,103,28,78.63,13,7,48.8
2024-06-15,92,80,12,86.96,12,5,49.0
2024-06-18,158,139,19,87.97,13,9,49.2
2024-06-19,148,122,26,82.43,23,1,49.3
2024-06-20,89,79,10,88.76,14,5,49.5
2024-06-23,153,144,9,94.12,17,9,49.7
2024-06-25,107,80,27,74.77,5,9,49.8
2024-06-28,81,59,22,72.84,18,0,50.0
2024-06-30,126,120,6,95.24,10,6,50.2
2024-07-03,82,60,22,73.17,11,0,50.3
2024-07-04,162,150,12,92.59,25,1,50.5
2024-07-06,90,72,18,80.0,17,6,50.7
2024-07-08,123,94,29,76.42,24,8,50.8
2024-07-10,74,45,29,60.81,19,1,51.0
2024-07-12,95,66,29,69.47,29,0,51.2
2024-07-15,74,58,16,78.38,29,6,51.3
2024-07-17,148,126,22,85.14,14,3,51.5
2024-07-20,156,143,13,91.67,22,2,51.7
2024-07-22,90,68,22,75.56,23,9,51.8
2024-07-23,107,85,22,79.44,14,7,52.0
2024-07-26,126,107,19,84.92,8,1,52.2
2024-07-27,147,142,5,96.6,12,8,52.3
2024-07-29,102,90,12,88.24,28,3,52.5
2024-08-01,81,57,24,70.37,16,3,52.7
2024-08-02,153,124,29,81.05,13,1,52.8
2024-08-04,123,104,19,84.55,24,1,53.0
2024-08-05,130,115,15,88.46,14,9,53.2
2024-08-06,83,55,28,66.27,5,8,53.3
2024-08-09,150,130,20,86.67,8,8,53.5
2024-08-12,89,75,14,84.27,15,6,53.7
2024-08-13,85,57,28,67.06,14,3,53.8
2024-08-16,119,100,19,84.03,10,4,54.0
2024-08-19,136,108,28,79.41,29,5,54.2
2024-08-21,101,74,27,73.27,15,7,54.3
2024-08-23,106,84,22,79.25,8,5,54.5
2024-08-26,131,106,25,80.92,22,1,54.7
2024-08-27,80,63,17,78.75,14,1,54.8
2024-08-29,100,93,7,93.0,15,3,55.0
2024-09-01,143,124,19,86.71,11,4,55.2
2024-09-04,91,76,15,83.52,17,3,55.3
2024-09-06,145,133,12,91.72,28,1,55.5
2024-09-08,106,96,10,90.57,9,4,55.7
2024-09-09,162,155,7,95.68,17,8,55.8
2024-09-10,120,99,21,82.5,8,0,56.0
2024-09-12,148,139,9,93.92,21,8,56.2
2024-09-15,121,97,24,80.17,19,0,56.3
2024-09-18,155,144,11,92.9,13,5,56.5
2024-09-20,93,79,14,84.95,8,2,56.7
2024-09-21,139,113,26,81.29,25,7,56.8
2024-09-24,114,99,15,86.84,29,2,57.0
2024-09-27,123,99,24,80.49,18,9,57.2
2024-09-30,111,84,27,75.68,5,6,57.3
2024-10-03,89,71,18,79.78,25,5,57.5
2024-10-05,115,102,13,88.7,27,2,57.7
2024-10-06,85,75,10,88.24,18,6,57.8
2024-10-09,89,63,26,70.79,17,7,58.0
2024-10-11,110,94,16,85.45,27,0,58.2
2024-10-12,93,78,15,83.87,24,2,58.3
2024-10-14,122,111,11,90.98,19,6,58.5
2024-10-16,71,48,23,67.61,20,3,58.7
2024-10-18,155,149,6,96.13,15,1,58.8
2024-10-19,138,113,25,81.88,5,0,59.0
2024-10-20,163,153,10,93.87,23,7,59.2
2024-10-22,157,143,14,91.08,24,8,59.3
2024-10-25,94,72,22,76.6,6,2,59.5
2024-10-26,113,101,12,89.38,8,1,59.7
2024-10-27,118,98,20,83.05,24,1,59.8
2024-10-29,110,87,23,79.09,5,6,60.0
2024-10-30,163,142,21,87.12,29,7,60.2
2024-10-31,153,134,19,87.58,5,6,60.3
2024-11-01,146,120,26,82.19,29,3,60.5
2024-11-04,78,51,27,65.38,21,5,60.7
2024-11-06,129,112,17,86.82,15,4,60.8
2024-11-09,129,122,7,94.57,21,0,61.0
2024-11-10,155,132,23,85.16,22,1,61.2
2024-11-11,166,141,25,84.94,18,8,61.3
2024-11-12,133,108,25,81.2,8,6,61.5
2024-11-14,128,118,10,92.19,16,2,61.7
2024-11-17,82,59,23,71.95,26,5,61.8
2024-11-19,122,105,17,86.07,18,7,62.0
2024-11-22,84,58,26,69.05,22,0,62.2
2024-11-25,100,84,16,84.0,8,9,62.3
2024-11-26,83,71,12,85.54,19,9,62.5
2024-11-27,102,80,22,78.43,20,7,62.7
2024-11-30,89,61,28,68.54,28,5,62.8
2024-12-03,101,88,13,87.13,6,5,63.0
2024-12-04,101,79,22,78.22,5,2,63.2
2024-12-07,85,80,5,94.12,29,5,63.3
2024-12-09,88,68,20,77.27,18,3,63.5
2024-12-12,139,132,7,94.96,7,7,63.7
2024-12-15,128,102,26,79.69,5,2,63.8
2024-12-16,147,141,6,95.92,16,6,64.0
2024-12-19,154,131,23,85.06,15,6,64.2
2024-12-21,87,73,14,83.91,19,0,64.3
2024-12-24,77,58,19,75.32,21,2,64.5
2024-12-27,164,143,21,87.2,16,7,64.7
2024-12-28,141,134,7,95.04,26,4,64.8
2024-12-30,106,78,28,73.58,13,6,65.0
