Date,Test_Executed,Test_Passed,Test_Failed,Pass_Rate(%),Open_Bugs,Critical_Bugs,Code_Coverage
2024-01-01,70,43,27,61.43,29,5,35.0
2024-01-03,117,101,16,86.32,15,3,35.2
2024-01-04,70,50,20,71.43,12,6,35.3
2024-01-06,144,124,20,86.11,26,3,35.5
2024-01-07,93,66,27,70.97,24,1,35.6
2024-01-10,109,83,26,76.15,18,7,35.8
2024-01-13,83,74,9,89.16,15,9,36.0
2024-01-15,147,120,27,81.63,5,9,36.1
2024-01-16,72,66,6,91.67,16,5,36.3
2024-01-19,126,111,15,88.1,27,3,36.5
2024-01-22,120,91,29,75.83,13,6,36.6
2024-01-24,110,101,9,91.82,20,0,36.8
2024-01-25,109,99,10,90.83,18,3,36.9
2024-01-26,79,53,26,67.09,27,0,37.1
2024-01-28,79,56,23,70.89,7,1,37.3
2024-01-30,138,128,10,92.75,25,8,37.4
2024-01-31,164,147,17,89.63,29,6,37.6
2024-02-03,121,98,23,80.99,15,8,37.7
2024-02-04,90,79,11,87.78,6,4,37.9
2024-02-07,101,84,17,83.17,12,1,38.1
2024-02-10,125,116,9,92.8,15,7,38.2
2024-02-12,143,136,7,95.1,21,5,38.4
2024-02-14,152,144,8,94.74,12,6,38.5
2024-02-17,137,115,22,83.94,18,3,38.7
2024-02-18,88,73,15,82.95,13,2,38.9
2024-02-20,169,152,17,89.94,19,4,39.0
2024-02-21,77,55,22,71.43,18,4,39.2
2024-02-23,147,119,28,80.95,25,3,39.4
2024-02-24,84,62,22,73.81,29,4,39.5
2024-02-26,163,158,5,96.93,12,6,39.7
2024-02-27,95,82,13,86.32,26,5,39.8
2024-03-01,153,148,5,96.73,24,2,40.0
2024-03-04,122,97,25,79.51,26,7,40.2
2024-03-05,169,152,17,89.94,28,4,40.3
2024-03-06,115,102,13,88.7,6,8,40.5
2024-03-07,75,69,6,92.0,27,8,40.6
2024-03-09,125,97,28,77.6,21,1,40.8
2024-03-10,115,90,25,78.26,19,0,41.0
2024-03-11,83,65,18,78.31,17,7,41.1
2024-03-14,133,109,24,81.95,14,5,41.3
2024-03-16,144,124,20,86.11,18,2,41.5
2024-03-19,106,101,5,95.28,11,0,41.6
2024-03-22,125,105,20,84.0,21,2,41.8
2024-03-25,125,109,16,87.2,15,2,41.9
2024-03-28,94,82,12,87.23,24,4,42.1
2024-03-29,157,152,5,96.82,12,9,42.3
2024-04-01,87,70,17,80.46,11,2,42.4
2024-04-03,76,47,29,61.84,13,4,42.6
2024-04-06,78,70,8,89.74,20,0,42.7
2024-04-09,143,125,18,87.41,15,3,42.9
2024-04-12,81,54,27,66.67,12,3,43.1
2024-04-13,128,117,11,91.41,28,5,43.2
2024-04-16,109,87,22,79.82,11,2,43.4
2024-04-17,157,134,23,85.35,14,4,43.5
2024-04-19,117,99,18,84.62,9,6,43.7
2024-04-20,167,146,21,87.43,6,6,43.9
2024-04-21,161,153,8,95.03,28,0,44.0
2024-04-24,146,136,10,93.15,26,8,44.2
2024-04-25,126,118,8,93.65,29,7,44.4
2024-04-27,79,69,10,87.34,18,8,44.5
2024-04-29,128,118,10,92.19,19,7,44.7
2024-05-01,138,133,5,96.38,28,6,44.8
2024-05-04,160,133,27,83.12,7,5,45.0
2024-05-06,84,63,21,75.0,14,3,45.2
2024-05-07,92,73,19,79.35,26,8,45.3
2024-05-08,103,92,11,89.32,19,5,45.5
2024-05-10,142,129,13,90.85,27,4,45.6
2024-05-12,126,106,20,84.13,19,0,45.8
2024-05-14,111,100,11,90.09,21,8,46.0
2024-05-15,153,126,27,82.35,8,5,46.1
2024-05-16,151,142,9,94.04,20,4,46.3
2024-05-18,106,77,29,72.64,14,4,46.5
2024-05-19,134,112,22,83.58,6,8,46.6
2024-05-22,138,110,28,79.71,26,7,46.8
2024-05-23,115,90,25,78.26,13,8,46.9
2024-05-25,92,71,21,77.17,10,5,47.1
2024-05-27,135,113,22,83.7,6,4,47.3
2024-05-30,104,77,27,74.04,23,8,47.4
2024-06-01,157,143,14,91.08,29,0,47.6
2024-06-04,124,111,13,89.52,6,2,47.7
2024-06-06,76,56,20,73.68,27,7,47.9
2024-06-07,109,89,20,81.65,9,2,48.1
2024-06-08,107,91,16,85.05,28,3,48.2
2024-06-09,98,86,12,87.76,28,4,48.4
2024-06-12,128,105,23,82.03,27,9,48.5
2024-06-15,155,140,15,90.32,20,7,48.7
2024-06-16,96,78,18,81.25,7,1,48.9
2024-06-17,152,131,21,86.18,15,3,49.0
2024-06-18,95,70,25,73.68,23,6,49.2
2024-06-20,135,123,12,91.11,27,1,49.4
2024-06-21,105,85,20,80.95,19,7,49.5
2024-06-22,134,113,21,84.33,14,2,49.7
2024-06-24,100,72,28,72.0,25,0,49.8
2024-06-27,102,81,21,79.41,6,2,50.0
2024-06-30,104,94,10,90.38,5,5,50.2
2024-07-03,166,150,16,90.36,25,3,50.3
2024-07-04,110,86,24,78.18,21,6,50.5
2024-07-06,80,54,26,67.5,8,7,50.6
2024-07-09,84,55,29,65.48,18,1,50.8
2024-07-11,129,122,7,94.57,25,2,51.0
2024-07-14,146,126,20,86.3,8,8,51.1
2024-07-17,142,134,8,94.37,29,4,51.3
2024-07-19,99,87,12,87.88,23,0,51.5
2024-07-21,71,63,8,88.73,16,0,51.6
2024-07-22,106,77,29,72.64,29,6,51.8
2024-07-24,114,86,28,75.44,21,6,51.9
2024-07-27,119,113,6,94.96,19,2,52.1
2024-07-29,136,108,28,79.41,5,6,52.3
2024-08-01,135,115,20,85.19,5,5,52.4
2024-08-04,76,62,14,81.58,13,8,52.6
2024-08-05,169,154,15,91.12,24,0,52.7
2024-08-07,106,98,8,92.45,12,4,52.9
2024-08-10,93,75,18,80.65,21,3,53.1
2024-08-13,71,42,29,59.15,20,5,53.2
2024-08-16,136,107,29,78.68,27,2,53.4
2024-08-17,77,58,19,75.32,14,9,53.5
2024-08-20,99,90,9,90.91,23,5,53.7
2024-08-22,135,106,29,78.52,7,3,53.9
2024-08-25,84,70,14,83.33,24,0,54.0
2024-08-27,132,127,5,96.21,29,1,54.2
2024-08-30,123,108,15,87.8,8,6,54.4
2024-08-31,166,148,18,89.16,8,1,54.5
2024-09-01,106,96,10,90.57,18,7,54.7
2024-09-04,72,50,22,69.44,23,5,54.8
2024-09-05,115,100,15,86.96,18,0,55.0
2024-09-07,161,150,11,93.17,17,0,55.2
2024-09-10,124,116,8,93.55,18,5,55.3
2024-09-13,94,66,28,70.21,16,5,55.5
2024-09-15,113,84,29,74.34,23,8,55.6
2024-09-18,146,119,27,81.51,20,1,55.8
2024-09-21,129,118,11,91.47,27,7,56.0
2024-09-23,126,108,18,85.71,27,2,56.1
2024-09-24,70,65,5,92.86,20,4,56.3
2024-09-25,164,158,6,96.34,17,3,56.5
2024-09-26,127,107,20,84.25,6,4,56.6
2024-09-27,114,102,12,89.47,11,4,56.8
2024-09-29,104,95,9,91.35,13,5,56.9
2024-10-01,154,137,17,88.96,12,0,57.1
2024-10-03,152,144,8,94.74,26,8,57.3
2024-10-05,147,132,15,89.8,20,5,57.4
2024-10-06,129,120,9,93.02,8,1,57.6
2024-10-09,129,112,17,86.82,11,2,57.7
2024-10-11,100,80,20,80.0,16,4,57.9
2024-10-13,94,76,18,80.85,28,3,58.1
2024-10-14,111,96,15,86.49,8,8,58.2
2024-10-16,123,113,10,91.87,20,2,58.4
2024-10-17,132,114,18,86.36,25,8,58.5
2024-10-20,146,120,26,82.19,23,7,58.7
2024-10-23,76,52,24,68.42,12,2,58.9
2024-10-24,157,143,14,91.08,14,3,59.0
2024-10-26,71,60,11,84.51,20,5,59.2
2024-10-29,156,133,23,85.26,21,1,59.4
2024-11-01,154,143,11,92.86,16,5,59.5
2024-11-03,157,152,5,96.82,19,6,59.7
2024-11-06,150,143,7,95.33,29,5,59.8
2024-11-09,151,145,6,96.03,11,6,60.0
2024-11-10,146,141,5,96.58,25,2,60.2
2024-11-11,116,88,28,75.86,23,4,60.3
2024-11-12,147,119,28,80.95,5,0,60.5
2024-11-13,123,113,10,91.87,20,9,60.6
2024-11-15,102,97,5,95.1,12,3,60.8
2024-11-16,162,157,5,96.91,12,1,61.0
2024-11-18,116,108,8,93.1,8,4,61.1
2024-11-20,157,130,27,82.8,19,3,61.3
2024-11-21,98,85,13,86.73,8,9,61.5
2024-11-22,149,121,28,81.21,19,0,61.6
2024-11-23,129,118,11,91.47,20,0,61.8
2024-11-24,144,115,29,79.86,26,0,61.9
2024-11-26,160,149,11,93.12,21,8,62.1
2024-11-28,102,87,15,85.29,13,7,62.3
2024-12-01,145,134,11,92.41,10,8,62.4
2024-12-03,88,68,20,77.27,20,1,62.6
2024-12-05,117,92,25,78.63,28,7,62.7
2024-12-07,144,130,14,90.28,25,2,62.9
2024-12-10,92,69,23,75.0,17,6,63.1
2024-12-12,138,123,15,89.13,9,9,63.2
2024-12-13,147,133,14,90.48,10,7,63.4
2024-12-15,147,129,18,87.76,9,3,63.5
2024-12-18,139,127,12,91.37,8,7,63.7
2024-12-19,100,95,5,95.0,29,1,63.9
2024-12-22,137,118,19,86.13,10,9,64.0
2024-12-23,125,101,24,80.8,22,5,64.2
2024-12-24,101,87,14,86.14,12,0,64.4
2024-12-25,92,76,16,82.61,18,2,64.5
2024-12-27,169,148,21,87.57,6,6,64.7
2024-12-29,86,65,21,75.58,25,1,64.8
2024-12-31,134,107,27,79.85,10,1,65.0
