Date,Test_Executed,Test_Passed,Test_Failed,Pass_Rate(%),Open_Bugs,Critical_Bugs,Code_Coverage
2024-01-01,178,160,18,89.89,18,8,40.0
2024-01-02,179,173,6,96.65,9,9,40.2
2024-01-05,114,85,29,74.56,18,2,40.3
2024-01-06,96,86,10,89.58,15,7,40.5
2024-01-09,142,134,8,94.37,15,3,40.7
2024-01-11,160,140,20,87.5,7,5,40.8
2024-01-14,158,142,16,89.87,14,5,41.0
2024-01-17,116,106,10,91.38,20,1,41.1
2024-01-19,161,156,5,96.89,16,5,41.3
2024-01-22,101,91,10,90.1,22,4,41.5
2024-01-23,172,159,13,92.44,12,1,41.6
2024-01-25,175,158,17,90.29,27,0,41.8
2024-01-27,91,77,14,84.62,14,6,42.0
2024-01-30,130,124,6,95.38,28,1,42.1
2024-01-31,170,150,20,88.24,21,9,42.3
2024-02-01,156,129,27,82.69,28,0,42.4
2024-02-02,130,113,17,86.92,21,7,42.6
2024-02-04,174,150,24,86.21,15,2,42.8
2024-02-07,123,108,15,87.8,12,1,42.9
2024-02-10,114,93,21,81.58,6,0,43.1
2024-02-12,121,109,12,90.08,6,8,43.3
2024-02-14,96,83,13,86.46,29,0,43.4
2024-02-16,171,155,16,90.64,27,2,43.6
2024-02-17,148,129,19,87.16,6,0,43.8
2024-02-18,119,92,27,77.31,25,6,43.9
2024-02-21,161,140,21,86.96,19,8,44.1
2024-02-23,155,133,22,85.81,12,6,44.2
2024-02-24,116,94,22,81.03,10,3,44.4
2024-02-27,107,78,29,72.9,13,9,44.6
2024-02-28,178,159,19,89.33,24,3,44.7
2024-03-02,89,69,20,77.53,20,3,44.9
2024-03-04,143,137,6,95.8,26,8,45.1
2024-03-05,128,99,29,77.34,15,2,45.2
2024-03-07,177,159,18,89.83,8,5,45.4
2024-03-09,108,82,26,75.93,16,8,45.5
2024-03-11,108,89,19,82.41,27,2,45.7
2024-03-13,178,155,23,87.08,6,7,45.9
2024-03-14,83,61,22,73.49,27,1,46.0
2024-03-17,157,135,22,85.99,13,0,46.2
2024-03-19,136,112,24,82.35,18,8,46.4
2024-03-21,143,114,29,79.72,13,9,46.5
2024-03-22,99,85,14,85.86,27,1,46.7
2024-03-23,112,105,7,93.75,18,1,46.8
2024-03-26,122,93,29,76.23,12,8,47.0
2024-03-28,146,124,22,84.93,12,6,47.2
2024-03-31,146,118,28,80.82,16,7,47.3
2024-04-01,109,96,13,88.07,13,9,47.5
2024-04-04,160,138,22,86.25,5,9,47.7
2024-04-07,154,146,8,94.81,26,3,47.8
2024-04-09,85,63,22,74.12,22,8,48.0
2024-04-12,84,75,9,89.29,19,2,48.2
2024-04-15,175,153,22,87.43,7,1,48.3
2024-04-17,103,78,25,75.73,22,4,48.5
2024-04-18,92,77,15,83.7,9,2,48.6
2024-04-21,130,106,24,81.54,27,7,48.8
2024-04-23,178,160,18,89.89,11,7,49.0
2024-04-25,137,116,21,84.67,19,8,49.1
2024-04-28,156,151,5,96.79,28,2,49.3
2024-05-01,89,62,27,69.66,12,6,49.5
2024-05-02,178,166,12,93.26,9,7,49.6
2024-05-05,168,149,19,88.69,6,1,49.8
2024-05-06,110,100,10,90.91,11,0,49.9
2024-05-08,150,144,6,96.0,17,7,50.1
2024-05-10,115,106,9,92.17,18,7,50.3
2024-05-12,113,85,28,75.22,19,0,50.4
2024-05-13,173,155,18,89.6,16,4,50.6
2024-05-15,129,100,29,77.52,18,3,50.8
2024-05-17,142,123,19,86.62,5,3,50.9
2024-05-18,173,165,8,95.38,6,6,51.1
2024-05-19,169,144,25,85.21,21,4,51.2
2024-05-21,85,62,23,72.94,17,5,51.4
2024-05-22,97,73,24,75.26,11,9,51.6
2024-05-25,176,161,15,91.48,8,1,51.7
2024-05-27,159,133,26,83.65,28,7,51.9
2024-05-30,148,124,24,83.78,9,9,52.1
2024-06-02,98,93,5,94.9,12,8,52.2
2024-06-03,113,103,10,91.15,13,8,52.4
2024-06-04,106,90,16,84.91,19,1,52.6
2024-06-07,89,71,18,79.78,18,7,52.7
2024-06-10,148,119,29,80.41,20,2,52.9
2024-06-13,169,146,23,86.39,19,3,53.0
2024-06-14,131,103,28,78.63,9,1,53.2
2024-06-15,85,76,9,89.41,10,8,53.4
2024-06-18,121,101,20,83.47,25,9,53.5
2024-06-19,163,157,6,96.32,21,2,53.7
2024-06-21,106,82,24,77.36,28,6,53.9
2024-06-22,149,140,9,93.96,5,1,54.0
2024-06-25,152,135,17,88.82,20,5,54.2
2024-06-28,115,101,14,87.83,28,4,54.3
2024-06-29,90,84,6,93.33,14,3,54.5
2024-07-01,126,107,19,84.92,15,5,54.7
2024-07-02,116,105,11,90.52,27,5,54.8
2024-07-03,137,110,27,80.29,23,4,55.0
2024-07-06,93,75,18,80.65,17,7,55.2
2024-07-07,165,152,13,92.12,24,5,55.3
2024-07-09,137,132,5,96.35,16,5,55.5
2024-07-12,85,63,22,74.12,22,1,55.7
2024-07-14,173,153,20,88.44,13,0,55.8
2024-07-16,155,137,18,88.39,16,8,56.0
2024-07-19,179,151,28,84.36,5,1,56.1
2024-07-20,129,109,20,84.5,17,9,56.3
2024-07-22,165,140,25,84.85,28,7,56.5
2024-07-23,129,105,24,81.4,20,4,56.6
2024-07-24,125,96,29,76.8,7,7,56.8
2024-07-26,150,140,10,93.33,28,2,57.0
2024-07-29,155,129,26,83.23,14,0,57.1
2024-08-01,132,114,18,86.36,6,7,57.3
2024-08-02,94,74,20,78.72,6,7,57.4
2024-08-05,161,150,11,93.17,21,7,57.6
2024-08-07,165,157,8,95.15,29,5,57.8
2024-08-08,115,107,8,93.04,22,2,57.9
2024-08-11,123,98,25,79.67,20,0,58.1
2024-08-12,101,89,12,88.12,26,6,58.3
2024-08-15,175,161,14,92.0,23,3,58.4
2024-08-16,96,87,9,90.62,7,7,58.6
2024-08-19,178,153,25,85.96,13,9,58.8
2024-08-20,150,130,20,86.67,9,7,58.9
2024-08-23,133,112,21,84.21,26,6,59.1
2024-08-24,81,54,27,66.67,25,2,59.2
2024-08-25,95,70,25,73.68,5,8,59.4
2024-08-28,136,121,15,88.97,11,7,59.6
2024-08-30,136,121,15,88.97,18,2,59.7
2024-09-01,156,137,19,87.82,7,6,59.9
2024-09-03,103,98,5,95.15,26,7,60.1
2024-09-04,137,125,12,91.24,20,9,60.2
2024-09-05,156,148,8,94.87,22,1,60.4
2024-09-08,126,113,13,89.68,7,4,60.5
2024-09-09,143,130,13,90.91,5,1,60.7
2024-09-11,102,80,22,78.43,17,0,60.9
2024-09-12,129,116,13,89.92,7,6,61.0
2024-09-15,120,112,8,93.33,11,1,61.2
2024-09-16,112,107,5,95.54,29,6,61.4
2024-09-19,88,66,22,75.0,11,0,61.5
2024-09-20,105,95,10,90.48,29,9,61.7
2024-09-23,147,118,29,80.27,14,9,61.8
2024-09-25,87,70,17,80.46,20,1,62.0
2024-09-26,110,87,23,79.09,27,2,62.2
2024-09-27,111,89,22,80.18,18,8,62.3
2024-09-29,169,159,10,94.08,18,5,62.5
2024-10-01,138,115,23,83.33,21,6,62.7
2024-10-02,105,88,17,83.81,10,2,62.8
2024-10-03,88,81,7,92.05,9,8,63.0
2024-10-04,125,114,11,91.2,14,6,63.2
2024-10-05,95,75,20,78.95,11,6,63.3
2024-10-06,111,102,9,91.89,13,4,63.5
2024-10-08,102,84,18,82.35,20,8,63.6
2024-10-11,170,150,20,88.24,29,8,63.8
2024-10-12,158,137,21,86.71,23,9,64.0
2024-10-15,160,138,22,86.25,19,6,64.1
2024-10-17,124,102,22,82.26,21,9,64.3
2024-10-20,109,93,16,85.32,8,1,64.5
2024-10-21,179,156,23,87.15,12,6,64.6
2024-10-22,174,149,25,85.63,20,4,64.8
2024-10-25,123,103,20,83.74,5,5,64.9
2024-10-27,117,101,16,86.32,14,9,65.1
2024-10-30,155,128,27,82.58,29,5,65.3
2024-11-01,159,144,15,90.57,23,3,65.4
2024-11-04,94,85,9,90.43,11,2,65.6
2024-11-05,127,119,8,93.7,9,4,65.8
2024-11-07,159,145,14,91.19,24,0,65.9
2024-11-09,121,93,28,76.86,27,5,66.1
2024-11-10,103,84,19,81.55,16,0,66.2
2024-11-12,95,87,8,91.58,16,0,66.4
2024-11-15,142,124,18,87.32,5,0,66.6
2024-11-17,161,149,12,92.55,20,9,66.7
2024-11-19,90,68,22,75.56,17,8,66.9
2024-11-20,100,74,26,74.0,11,8,67.1
2024-11-21,176,155,21,88.07,11,8,67.2
2024-11-24,85,77,8,90.59,11,4,67.4
2024-11-26,87,58,29,66.67,7,9,67.6
2024-11-28,98,75,23,76.53,11,8,67.7
2024-12-01,171,162,9,94.74,20,0,67.9
2024-12-04,111,102,9,91.89,24,9,68.0
2024-12-06,106,81,25,76.42,23,3,68.2
2024-12-08,93,87,6,93.55,11,7,68.4
2024-12-11,143,133,10,93.01,22,2,68.5
2024-12-13,96,69,27,71.88,28,6,68.7
2024-12-16,107,84,23,78.5,6,1,68.9
2024-12-18,171,143,28,83.63,22,6,69.0
2024-12-21,93,65,28,69.89,14,9,69.2
2024-12-23,163,134,29,82.21,6,5,69.3
2024-12-25,177,153,24,86.44,25,4,69.5
2024-12-28,95,89,6,93.68,13,3,69.7
2024-12-29,147,124,23,84.35,17,7,69.8
2024-12-30,132,110,22,83.33,7,6,70.0
